R 802 802
NO ./textures/color1.xpm
SO ./textures/color2.xpm
WE ./textures/color3.xpm
EA ./textures/color4.xpm
S ./textures/pillar.xpm
C 176,247,255
F 194,72,12

111111111111111111111111111111111111
10000000000000021000000000000000001
10000000000000000000000000000000001
10000000000001111111101111111111121
1000000000000100000000000000000100111111111
1002000000001 10000000000000000000000000001
1000000000000111111121111111111111100000201
1000000001111120000000000000000000000000001
1000N00001111111111111111111111111111111111
10000000010000021
100000000100000011111 1111111111111
100000000000000000021 1000000000001
100000000000000000001 1000000000001
100000000000000000001 1111111111111
111111111111110111111
1111111 11111101
1000001 12000001
1111111 11111111
