R 800 800
NO ./textures/color1.xpm
SO ./textures/color2.xpm
WE ./textures/color3.xpm
EA ./textures/color4.xpm
S ./textures/pillar.xpm

C 176,247,255
F 194,72,12

11111111111111111111111111111111111
10000000000000001000000000000000001
10000000000000000000000000000000001
10002000000001111111101111111111101
10000N00000001000000000000000001001
10000000010010100000000000000000001
10000000000001111111011111111111111
10000000011111000000000000000000001
10000000011111111111111111111111111
10000000010000001
100000000100000011111
100000000000000000001
100000000000000000001
100000000000000000001
111111111111111111111
1111111
1000001
1111111
