R 640 640
NO ./textures/color1.xpm
SO ./textures/color2.xpm
WE ./textures/color3.xpm
EA ./textures/color4.xpm
S ./textures/pillar.xpm
F 220,100,0
C 225,30,0

1111111111111111111111111
1000000000110000000000001
1011000001110000002000001
1001000000000000000000001
10000000000000000000000001111111
111111111011000001110000000000001
100000000011000001110111111111111
11110111111111011100000010001
11110111111111011101010010001
11000000110101011100000010001
10002000000000001100000010001
100000 000000001101010010001
11000001110101011111011110N01
1111001111110101 101111010001
11111111 1111111 111111111111
